id	name	Stimmberechtigte	A1	A2	A3	Abstimmende	mit Stimmschein	Ungueltige Stimmen	Gueltige Stimmen	Ja-Stimmen	Nein-Stimmen
08111000	Stuttgart, Landeshauptstadt	368732				249978		894	249084	117310	131774
08115001	Aidlingen	6540				4138		5	4133	1263	2870
08115002	Altdorf	3211				2136		8	2128	662	1466
08115003	Böblingen, Stadt	31570				16373		50	16323	5947	10376
08115004	Bondorf	3964				2426		9	2417	913	1504
08115010	Deckenpfronn	2379				1495		11	1484	462	1022
08115013	Ehningen	5613				3545		19	3526	1097	2429
08115015	Gärtringen	8394				5156		18	5138	1619	3519
08115016	Gäufelden	6433				3787		15	3772	1221	2551
08115021	Herrenberg, Stadt	21917				13672		27	13645	5015	8630
08115022	Hildrizhausen	2500				1519		4	1515	438	1077
08115024	Holzgerlingen	8753				5235		20	5215	1736	3479
08115028	Leonberg, Stadt	31059				19178		117	19061	7811	11250
08115029	Magstadt	5690				3170		18	3152	988	2164
08115034	Mötzingen	2461				1383		3	1380	428	952
08115037	Nufringen	3967				2666		9	2657	856	1801
08115041	Renningen, Stadt	11837				7582		22	7560	3159	4401
08115042	Rutesheim, Stadt	7071				4573		13	4560	1642	2918
08115044	Schönaich	6776				4063		10	4053	1336	2717
08115045	Sindelfingen, Stadt	38342				19802		82	19720	6764	12956
08115046	Steinenbronn	4058				2496		19	2477	971	1506
08115048	Waldenbuch, Stadt	5996				3896		11	3885	1484	2401
08115050	Weil der Stadt, Stadt	13410				7870		28	7842	3058	4784
08115051	Weil im Schönbuch	6813				4168		10	4158	1397	2761
08115052	Weissach	5509				3630		11	3619	1299	2320
08115053	Jettingen	5205				3016		11	3005	795	2210
08115054	Grafenau	4732				2934		19	2915	885	2030
08116004	Altbach	3962				2475		9	2466	820	1646
08116005	Altdorf	1091				724		5	719	220	499
08116006	Altenriet	1392				900		0	900	304	596
08116007	Baltmannsweiler	4219				2664		10	2654	971	1683
08116008	Bempflingen	2554				1635		5	1630	576	1054
08116011	Beuren	2722				1648		9	1639	509	1130
08116012	Bissingen an der Teck	2551				1752		14	1738	633	1105
08116014	Deizisau	4586				2985		11	2974	1054	1920
08116015	Denkendorf	7237				4424		19	4405	1869	2536
08116016	Dettingen unter Teck	4204				2686		26	2660	1025	1635
08116018	Erkenbrechtsweiler	1622				962		1	961	271	690
08116019	Esslingen am Neckar, Stadt	58269				35266		138	35128	15501	19627
08116020	Frickenhausen	6339				3711		20	3691	1104	2587
08116022	Großbettlingen	3178				1892		7	1885	627	1258
08116027	Hochdorf	3652				2419		8	2411	953	1458
08116029	Holzmaden	1596				1092		11	1081	483	598
08116033	Kirchheim unter Teck, Stadt	27769				15986		86	15900	7032	8868
08116035	Köngen	6802				4422		10	4412	1795	2617
08116036	Kohlberg	1758				1077		13	1064	272	792
08116037	Lichtenwald	1975				1342		1	1341	554	787
08116041	Neckartailfingen	2777				1736		7	1729	598	1131
08116042	Neckartenzlingen	4170				2360		3	2357	808	1549
08116043	Neidlingen	1341				896		5	891	243	648
08116046	Neuffen, Stadt	4572				2815		12	2803	811	1992
08116047	Neuhausen auf den Fildern	8476				5604		20	5584	2057	3527
08116048	Notzingen	2808				1890		5	1885	656	1229
08116049	Nürtingen, Stadt	27937				15798		60	15738	5699	10039
08116050	Oberboihingen	3939				2450		9	2441	803	1638
08116053	Ohmden	1324				886		5	881	306	575
08116054	Owen, Stadt	2529				1773		6	1767	570	1197
08116056	Plochingen, Stadt	9201				5573		21	5552	2243	3309
08116058	Reichenbach an der Fils	5550				3472		5	3467	1190	2277
08116063	Schlaitdorf	1353				923		3	920	317	603
08116068	Unterensingen	3347				2134		2	2132	803	1329
08116070	Weilheim an der Teck, Stadt	6705				4215		16	4199	1500	2699
08116071	Wendlingen am Neckar, Stadt	11000				6671		27	6644	2602	4042
08116072	Wernau (Neckar), Stadt	8685				5115		17	5098	1683	3415
08116073	Wolfschlugen	4690				3056		28	3028	1060	1968
08116076	Aichwald	5832				4126		9	4117	1497	2620
08116077	Filderstadt, Stadt	30650				19350		76	19274	7892	11382
08116078	Leinfelden-Echterdingen, Stadt	26053				17685		64	17621	8665	8956
08116079	Lenningen	5772				3434		10	3424	1089	2335
08116080	Ostfildern, Stadt	25684				17048		59	16989	7078	9911
08116081	Aichtal, Stadt	7310				4749		17	4732	1608	3124
08117001	Adelberg	1555				1027		4	1023	373	650
08117002	Aichelberg	978				598		1	597	250	347
08117003	Albershausen	3137				1796		4	1792	644	1148
08117006	Bad Ditzenbach	2786				1568		4	1564	500	1064
08117007	Bad Überkingen	3089				1878		3	1875	591	1284
08117009	Birenbach	1500				895		2	893	336	557
08117010	Böhmenkirch	4015				2166		6	2160	546	1614
08117011	Börtlingen	1352				841		4	837	315	522
08117012	Bad Boll	3864				2367		7	2360	1133	1227
08117014	Deggingen	4075				2293		8	2285	755	1530
08117015	Donzdorf, Stadt	8087				4497		9	4488	1339	3149
08117016	Drackenstein	339				180		1	179	64	115
08117017	Dürnau	1548				936		2	934	351	583
08117018	Ebersbach an der Fils, Stadt	10694				6520		20	6500	2408	4092
08117019	Eislingen/Fils, Stadt	13414				6154		19	6135	2352	3783
08117020	Eschenbach	1734				996		4	992	350	642
08117023	Gammelshausen	1133				647		0	647	192	455
08117024	Geislingen an der Steige, Stadt	17434				8162		68	8094	3456	4638
08117025	Gingen an der Fils	3177				1858		8	1850	611	1239
08117026	Göppingen, Stadt	38377				18509		60	18449	7598	10851
08117028	Gruibingen	1634				994		8	986	386	600
08117029	Hattenhofen	2323				1448		4	1444	437	1007
08117030	Heiningen	3856				2129		6	2123	788	1335
08117031	Hohenstadt	521				300		0	300	94	206
08117033	Kuchen	4147				2236		8	2228	882	1346
08117035	Mühlhausen im Täle	779				508		4	504	279	225
08117037	Ottenbach	1877				1070		2	1068	293	775
08117038	Rechberghausen	4185				2300		7	2293	830	1463
08117042	Salach	5415				2798		18	2780	883	1897
08117043	Schlat	1313				831		2	829	272	557
08117044	Schlierbach	2694				1680		10	1670	493	1177
08117049	Süßen, Stadt	6771				3689		10	3679	1372	2307
08117051	Uhingen, Stadt	9898				5361		18	5343	1869	3474
08117053	Wäschenbeuren	3001				1830		7	1823	621	1202
08117055	Wangen	2456				1534		6	1528	581	947
08117058	Wiesensteig	1560				677		3	674	270	404
08117060	Zell unter Aichelberg	2341				1527		4	1523	523	1000
08117061	Lauterstein, Stadt	2000				1138		16	1122	325	797
08118001	Affalterbach	3407				2259		11	2248	772	1476
08118003	Asperg, Stadt	8905				5603		14	5589	2110	3479
08118006	Benningen am Neckar	4297				2815		11	2804	1035	1769
08118007	Besigheim, Stadt	8459				5149		15	5134	1966	3168
08118010	Bönnigheim, Stadt	4914				2737		25	2712	974	1738
08118011	Ditzingen, Stadt	16559				10996		36	10960	4409	6551
08118012	Eberdingen	4641				2935		12	2923	1013	1910
08118014	Erdmannhausen	3573				2293		7	2286	983	1303
08118015	Erligheim	1992				1160		1	1159	359	800
08118016	Freudental	1764				1112		6	1106	485	621
08118018	Gemmrigheim	2576				1434		6	1428	388	1040
08118019	Gerlingen, Stadt	13516				9389		46	9343	3654	5689
08118021	Großbottwar, Stadt	5765				3628		14	3614	1311	2303
08118027	Hemmingen	5326				3376		4	3372	1163	2209
08118028	Hessigheim	1631				1000		2	998	269	729
08118040	Kirchheim am Neckar	3275				1772		5	1767	661	1106
08118046	Kornwestheim, Stadt	20542				11817		54	11763	4446	7317
08118047	Löchgau	3932				2414		5	2409	902	1507
08118048	Ludwigsburg, Stadt	57558				31253		128	31125	13852	17273
08118049	Marbach am Neckar, Stadt	10713				6652		13	6639	2780	3859
08118050	Markgröningen, Stadt	9612				5858		16	5842	2280	3562
08118051	Möglingen	7458				4278		13	4265	1617	2648
08118053	Mundelsheim	2409				1544		5	1539	471	1068
08118054	Murr	4501				2783		6	2777	923	1854
08118059	Oberriexingen, Stadt	2413				1562		20	1542	526	1016
08118060	Oberstenfeld	5569				3386		4	3382	1037	2345
08118063	Pleidelsheim	4182				2433		9	2424	926	1498
08118067	Schwieberdingen	7910				5005		7	4998	1737	3261
08118068	Sersheim	3692				2222		20	2202	779	1423
08118070	Steinheim an der Murr, Stadt	8705				5266		15	5251	1784	3467
08118071	Tamm	9202				5732		18	5714	2063	3651
08118073	Vaihingen an der Enz, Stadt	19758				12822		44	12778	4384	8394
08118074	Walheim	2314				1379		4	1375	498	877
08118076	Sachsenheim, Stadt	12349				7272		22	7250	2715	4535
08118077	Ingersheim	4413				2645		6	2639	998	1641
08118078	Freiberg am Neckar, Stadt	11555				7265		29	7236	2985	4251
08118079	Bietigheim-Bissingen, Stadt	28982				16230		41	16189	6655	9534
08118080	Korntal-Münchingen, Stadt	12675				8889		31	8858	3548	5310
08118081	Remseck am Neckar, Stadt	16395				10381		27	10354	3575	6779
08119001	Alfdorf	5405				3083		13	3070	965	2105
08119003	Allmersbach im Tal	3593				2164		16	2148	683	1465
08119004	Althütte	3116				1935		32	1903	617	1286
08119006	Auenwald	5343				3116		3	3113	892	2221
08119008	Backnang, Stadt	23668				12930		60	12870	4795	8075
08119018	Burgstetten	2576				1602		1	1601	512	1089
08119020	Fellbach, Stadt	29090				18805		58	18747	7300	11447
08119024	Großerlach	1958				960		4	956	348	608
08119037	Kaisersbach	1973				1049		6	1043	332	711
08119038	Kirchberg an der Murr	2638				1565		9	1556	530	1026
08119041	Korb	7423				4835		11	4824	1596	3228
08119042	Leutenbach	8086				4913		28	4885	1777	3108
08119044	Murrhardt, Stadt	9934				5025		9	5016	1813	3203
08119053	Oppenweiler	3043				1876		4	1872	645	1227
08119055	Plüderhausen	6695				4072		37	4035	1481	2554
08119061	Rudersberg	8394				4828		15	4813	1686	3127
08119067	Schorndorf, Stadt	28155				16716		43	16673	6446	10227
08119068	Schwaikheim	6395				4170		8	4162	1546	2616
08119069	Spiegelberg	1631				948		1	947	309	638
08119075	Sulzbach an der Murr	3732				2021		8	2013	655	1358
08119076	Urbach	6269				3777		8	3769	1267	2502
08119079	Waiblingen, Stadt	35506				21145		51	21094	8557	12537
08119083	Weissach im Tal	5449				3298		5	3293	1032	2261
08119084	Welzheim, Stadt	7816				4118		12	4106	1410	2696
08119085	Winnenden, Stadt	18523				10773		27	10746	3714	7032
08119086	Winterbach	5738				3917		2	3915	1543	2372
08119087	Aspach	5900				3353		14	3339	1094	2245
08119089	Berglen	4656				2951		4	2947	874	2073
08119090	Remshalden	10255				6992		23	6969	2501	4468
08119091	Weinstadt, Stadt	18869				12744		48	12696	4646	8050
08119093	Kernen im Remstal	11119				6977		49	6928	2767	4161
08121000	Heilbronn, Stadt	78153				32365		107	32258	13322	18936
08125001	Abstatt	3316				1898		4	1894	635	1259
08125005	Bad Friedrichshall, Stadt	12487				4790		18	4772	1722	3050
08125006	Bad Rappenau, Stadt	15583				6008		20	5988	2306	3682
08125007	Bad Wimpfen, Stadt	5024				2251		14	2237	897	1340
08125008	Beilstein, Stadt	4585				2783		4	2779	1020	1759
08125013	Brackenheim, Stadt	10906				5996		28	5968	2095	3873
08125017	Cleebronn	1947				1044		2	1042	268	774
08125021	Eberstadt	2393				1163		5	1158	466	692
08125024	Ellhofen	2530				1339		7	1332	523	809
08125026	Eppingen, Stadt	15077				6257		35	6222	2281	3941
08125027	Erlenbach	3798				1932		5	1927	592	1335
08125030	Flein	5081				2915		11	2904	1080	1824
08125034	Gemmingen	3488				1551		8	1543	586	957
08125038	Güglingen, Stadt	3748				1897		3	1894	687	1207
08125039	Gundelsheim, Stadt	5395				2107		4	2103	591	1512
08125046	Ilsfeld	6189				3536		12	3524	1187	2337
08125047	Ittlingen	1660				738		5	733	272	461
08125048	Jagsthausen	1076				494		0	494	214	280
08125049	Kirchardt	3818				1327		3	1324	418	906
08125056	Lauffen am Neckar, Stadt	7788				4264		17	4247	1782	2465
08125057	Lehrensteinsfeld	1642				862		1	861	307	554
08125058	Leingarten	8147				3905		13	3892	1533	2359
08125059	Löwenstein, Stadt	2379				1157		3	1154	440	714
08125061	Massenbachhausen	2624				1272		3	1269	370	899
08125063	Möckmühl, Stadt	5755				2304		6	2298	1029	1269
08125065	Neckarsulm, Stadt	16914				7086		31	7055	2562	4493
08125066	Neckarwestheim	2561				1404		0	1404	388	1016
08125068	Neudenau, Stadt	3768				1690		11	1679	546	1133
08125069	Neuenstadt am Kocher, Stadt	7155				3137		15	3122	1048	2074
08125074	Nordheim	5649				2983		11	2972	1160	1812
08125078	Oedheim	4433				2038		6	2032	676	1356
08125079	Offenau	1911				868		4	864	302	562
08125081	Pfaffenhofen	1625				847		16	831	291	540
08125084	Roigheim	1010				467		2	465	204	261
08125086	Schwaigern, Stadt	7878				4040		39	4001	1535	2466
08125087	Siegelsbach	1192				479		2	477	164	313
08125094	Talheim	3701				2061		7	2054	667	1387
08125096	Untereisesheim	2951				1381		6	1375	517	858
08125098	Untergruppenbach	6012				3314		7	3307	1285	2022
08125102	Weinsberg, Stadt	8431				4071		13	4058	1750	2308
08125103	Widdern, Stadt	1321				614		7	607	237	370
08125107	Wüstenrot	5112				2422		7	2415	853	1562
08125108	Zaberfeld	2936				1570		6	1564	630	934
08125110	Obersulm	10147				4922		25	4897	1676	3221
08125111	Hardthausen am Kocher	2894				1404		9	1395	425	970
08125113	Langenbrettach	2731				1269		4	1265	437	828
08126011	Bretzfeld	9319				4307		21	4286	1520	2766
08126020	Dörzbach	1867				979		4	975	299	676
08126028	Forchtenberg, Stadt	3763				1599		14	1585	579	1006
08126039	Ingelfingen, Stadt	4298				2193		10	2183	766	1417
08126045	Krautheim, Stadt	3582				1596		13	1583	500	1083
08126046	Künzelsau, Stadt	10787				4723		16	4707	1630	3077
08126047	Kupferzell	4289				1934		10	1924	661	1263
08126056	Mulfingen	2885				1456		10	1446	401	1045
08126058	Neuenstein, Stadt	4695				2101		9	2092	788	1304
08126060	Niedernhall, Stadt	2933				1348		9	1339	509	830
08126066	Öhringen, Stadt	16729				6561		32	6529	2664	3865
08126069	Pfedelbach	6903				3146		7	3139	1179	1960
08126072	Schöntal	4492				2321		17	2304	717	1587
08126085	Waldenburg, Stadt	2241				1062		3	1059	405	654
08126086	Weißbach	1479				563		1	562	201	361
08126094	Zweiflingen	1266				614		3	611	201	410
08127008	Blaufelden	3904				1678		4	1674	684	990
08127009	Braunsbach	1952				1045		4	1041	409	632
08127012	Bühlertann	2392				1125		5	1120	358	762
08127013	Bühlerzell	1593				778		5	773	260	513
08127014	Crailsheim, Stadt	24460				8962		25	8937	3493	5444
08127023	Fichtenberg	2253				1203		6	1197	512	685
08127025	Gaildorf, Stadt	8479				4065		12	4053	1723	2330
08127032	Gerabronn, Stadt	3347				1442		4	1438	645	793
08127043	Ilshofen, Stadt	4505				2064		11	2053	839	1214
08127046	Kirchberg an der Jagst, Stadt	3152				1626		8	1618	863	755
08127047	Langenburg, Stadt	1408				726		4	722	382	340
08127052	Mainhardt	4404				2189		7	2182	896	1286
08127056	Michelbach an der Bilz	2648				1481		4	1477	718	759
08127059	Michelfeld	2883				1564		7	1557	612	945
08127062	Oberrot	2641				1294		4	1290	518	772
08127063	Obersontheim	3651				1612		11	1601	566	1035
08127071	Rot am See	4030				1760		3	1757	734	1023
08127073	Satteldorf	4007				1840		5	1835	751	1084
08127075	Schrozberg, Stadt	4437				1845		7	1838	798	1040
08127076	Schwäbisch Hall, Stadt	27307				13082		63	13019	6604	6415
08127079	Sulzbach-Laufen	1951				1007		4	1003	344	659
08127086	Untermünkheim	2294				1213		5	1208	467	741
08127089	Vellberg, Stadt	3190				1570		4	1566	689	877
08127091	Wallhausen	2667				1033		4	1029	437	592
08127099	Wolpertshausen	1474				710		5	705	314	391
08127100	Rosengarten	3844				1972		6	1966	887	1079
08127101	Kreßberg	2964				1307		5	1302	542	760
08127102	Fichtenau	3488				1174		3	1171	450	721
08127103	Frankenhardt	3703				1626		3	1623	673	950
08127104	Stimpfach	2258				1047		6	1041	338	703
08128006	Assamstadt	1651				841		8	833	229	604
08128007	Bad Mergentheim, Stadt	17170				6890		25	6865	2398	4467
08128014	Boxberg, Stadt	5423				2230		17	2213	1000	1213
08128020	Creglingen, Stadt	3727				1495		8	1487	604	883
08128039	Freudenberg, Stadt	2952				947		7	940	363	577
08128045	Großrinderfeld	3243				1114		4	1110	368	742
08128047	Grünsfeld, Stadt	2965				1274		13	1261	473	788
08128058	Igersheim	4484				1914		10	1904	637	1267
08128061	Königheim	2544				1227		7	1220	502	718
08128064	Külsheim, Stadt	4250				1897		14	1883	554	1329
08128082	Niederstetten, Stadt	3933				1720		19	1701	623	1078
08128115	Tauberbischofsheim, Stadt	10196				4329		19	4310	1665	2645
08128126	Weikersheim, Stadt	5864				2558		13	2545	999	1546
08128128	Werbach	2761				1120		4	1116	400	716
08128131	Wertheim, Stadt	17675				5945		20	5925	2466	3459
08128137	Wittighausen	1318				533		0	533	184	349
08128138	Ahorn	1863				906		8	898	379	519
08128139	Lauda-Königshofen, Stadt	11408				4913		25	4888	1838	3050
08135010	Dischingen	3386				1779		9	1770	436	1334
08135015	Gerstetten	8788				4534		14	4520	1411	3109
08135016	Giengen an der Brenz, Stadt	13413				5221		17	5204	1828	3376
08135019	Heidenheim an der Brenz, Stadt	33636				14480		61	14419	5633	8786
08135020	Herbrechtingen, Stadt	9790				4522		11	4511	1585	2926
08135021	Hermaringen	1739				889		3	886	319	567
08135025	Königsbronn	5552				2884		11	2873	995	1878
08135026	Nattheim	4863				2245		6	2239	760	1479
08135027	Niederstotzingen, Stadt	3522				1786		6	1780	393	1387
08135031	Sontheim an der Brenz	4040				2097		4	2093	564	1529
08135032	Steinheim am Albuch	6699				3406		11	3395	1093	2302
08136002	Abtsgmünd	5750				2976		10	2966	928	2038
08136003	Adelmannsfelden	1387				757		2	755	211	544
08136007	Bartholomä	1663				846		1	845	202	643
08136009	Böbingen an der Rems	3474				1786		2	1784	545	1239
08136010	Bopfingen, Stadt	9020				3545		7	3538	1096	2442
08136015	Durlangen	2184				1160		2	1158	270	888
08136018	Ellenberg	1313				659		1	658	141	517
08136019	Ellwangen (Jagst), Stadt	18092				8848		28	8820	2574	6246
08136020	Eschach	1113				705		1	704	211	493
08136021	Essingen	4916				2467		11	2456	831	1625
08136024	Göggingen	1874				946		4	942	233	709
08136027	Gschwend	3834				1968		10	1958	693	1265
08136028	Heubach, Stadt	7114				3411		13	3398	1243	2155
08136029	Heuchlingen	1466				764		1	763	109	654
08136033	Hüttlingen	4552				2270		5	2265	679	1586
08136034	Iggingen	1982				1083		1	1082	246	836
08136035	Jagstzell	1814				960		3	957	248	709
08136037	Kirchheim am Ries	1420				693		3	690	225	465
08136038	Lauchheim, Stadt	3633				1797		6	1791	567	1224
08136040	Leinzell	1591				735		0	735	253	482
08136042	Lorch, Stadt	7929				4814		13	4801	1625	3176
08136043	Mögglingen	3175				1717		5	1712	553	1159
08136044	Mutlangen	4792				2559		8	2551	771	1780
08136045	Neresheim, Stadt	6079				2916		13	2903	824	2079
08136046	Neuler	2416				1379		1	1378	317	1061
08136049	Obergröningen	343				140		0	140	39	101
08136050	Oberkochen, Stadt	5855				2779		7	2772	1129	1643
08136060	Rosenberg	2069				1182		1	1181	312	869
08136061	Ruppertshofen	1384				623		6	617	153	464
08136062	Schechingen	1828				951		4	947	229	718
08136065	Schwäbisch Gmünd, Stadt	41769				20517		75	20442	6598	13844
08136066	Spraitbach	2638				1361		4	1357	392	965
08136068	Stödtlen	1498				642		1	641	159	482
08136070	Täferrot	786				399		1	398	108	290
08136071	Tannhausen	1443				593		0	593	108	485
08136075	Unterschneidheim	3521				1741		3	1738	358	1380
08136079	Waldstetten	5558				3277		9	3268	846	2422
08136082	Westhausen	4563				2282		10	2272	643	1629
08136084	Wört	1056				471		1	470	121	349
08136087	Riesbürg	1723				720		1	719	207	512
08136088	Aalen, Stadt	48258				23052		83	22969	8889	14080
08136089	Rainau	2492				1334		10	1324	323	1001
08211000	Baden-Baden, Stadt	39098				15226		68	15158	7028	8130
08212000	Karlsruhe, Stadt	202741				82652		431	82221	44048	38173
08215007	Bretten, Stadt	19554				8929		40	8889	3489	5400
08215009	Bruchsal, Stadt	30925				12472		49	12423	5186	7237
08215017	Ettlingen, Stadt	29087				13199		43	13156	5724	7432
08215021	Forst	5836				2497		31	2466	927	1539
08215025	Gondelsheim	2517				1132		5	1127	555	572
08215029	Hambrücken	4229				1893		10	1883	645	1238
08215039	Kronau	4318				1669		19	1650	657	993
08215040	Kürnbach	1745				861		2	859	361	498
08215046	Malsch	10869				4416		15	4401	2127	2274
08215047	Marxzell	4111				1769		6	1763	661	1102
08215059	Oberderdingen	6969				3181		16	3165	1195	1970
08215064	Östringen, Stadt	9548				3694		12	3682	1436	2246
08215066	Philippsburg, Stadt	8535				2875		15	2860	1116	1744
08215082	Sulzfeld	3395				1548		4	1544	620	924
08215084	Ubstadt-Weiher	9899				4373		18	4355	1577	2778
08215089	Walzbachtal	7090				3240		16	3224	1329	1895
08215090	Weingarten (Baden)	7486				3394		16	3378	1564	1814
08215094	Zaisenhausen	1224				476		4	472	165	307
08215096	Karlsbad	12095				5547		32	5515	2505	3010
08215097	Kraichtal, Stadt	10989				4666		18	4648	1917	2731
08215099	Graben-Neudorf	8842				3145		12	3133	1278	1855
08215100	Bad Schönborn	8874				3681		18	3663	1551	2112
08215101	Pfinztal	13461				7843		115	7728	3201	4527
08215102	Eggenstein-Leopoldshafen	12206				4978		30	4948	2154	2794
08215103	Karlsdorf-Neuthard	7424				2927		18	2909	1050	1859
08215105	Linkenheim-Hochstetten	8878				3593		18	3575	1530	2045
08215106	Waghäusel, Stadt	15629				5263		43	5220	2259	2961
08215107	Oberhausen-Rheinhausen	7537				2615		31	2584	1190	1394
08215108	Rheinstetten, Stadt	16121				6127		26	6101	2956	3145
08215109	Stutensee, Stadt	17269				7306		29	7277	3261	4016
08215110	Waldbronn	9562				4545		20	4525	1800	2725
08215111	Dettenheim	5610				2032		13	2019	819	1200
08216002	Au am Rhein	2631				964		6	958	403	555
08216005	Bietigheim	4705				1695		8	1687	912	775
08216006	Bischweier	2321				986		5	981	410	571
08216007	Bühl, Stadt	21394				8492		38	8454	3590	4864
08216008	Bühlertal	6237				1944		22	1922	900	1022
08216009	Durmersheim	9074				3223		15	3208	1606	1602
08216012	Elchesheim-Illingen	2534				925		5	920	464	456
08216013	Forbach	3802				1618		10	1608	559	1049
08216015	Gaggenau, Stadt	20962				8138		40	8098	3752	4346
08216017	Gernsbach, Stadt	10681				4243		16	4227	1883	2344
08216022	Hügelsheim	3454				889		2	887	390	497
08216023	Iffezheim	3766				1507		5	1502	617	885
08216024	Kuppenheim, Stadt	5842				2290		18	2272	1027	1245
08216028	Lichtenau, Stadt	3703				1445		5	1440	692	748
08216029	Loffenau	2000				662		4	658	270	388
08216033	Muggensturm	4713				1954		24	1930	962	968
08216039	Ötigheim	3506				1376		4	1372	621	751
08216041	Ottersweier	4775				1822		8	1814	756	1058
08216043	Rastatt, Stadt	33992				9803		32	9771	4607	5164
08216049	Sinzheim	8469				3644		11	3633	1592	2041
08216052	Steinmauern	2292				870		3	867	408	459
08216059	Weisenbach	1900				762		6	756	263	493
08216063	Rheinmünster	5079				1560		3	1557	682	875
08221000	Heidelberg, Stadt	94903				39726		193	39533	22928	16605
08222000	Mannheim, Universitätsstadt	196728				65531		315	65216	37313	27903
08225001	Adelsheim, Stadt	3708				1462		7	1455	550	905
08225002	Aglasterhausen	3711				1424		6	1418	660	758
08225009	Billigheim	4463				1891		3	1888	537	1351
08225010	Binau	1103				460		3	457	135	322
08225014	Buchen (Odenwald), Stadt	13855				5241		20	5221	1749	3472
08225024	Fahrenbach	2226				793		2	791	242	549
08225032	Hardheim	5340				1940		14	1926	601	1325
08225033	Haßmersheim	3543				1512		5	1507	559	948
08225039	Höpfingen	2472				893		5	888	275	613
08225042	Hüffenhardt	1664				635		3	632	238	394
08225052	Limbach	3586				1389		3	1386	402	984
08225058	Mosbach, Stadt	17202				6572		41	6531	2540	3991
08225060	Mudau	3978				1470		7	1463	427	1036
08225064	Neckargerach	1785				758		6	752	301	451
08225067	Neckarzimmern	1094				377		0	377	151	226
08225068	Neunkirchen	1453				546		5	541	228	313
08225074	Obrigheim	3821				1458		5	1453	533	920
08225075	Osterburken, Stadt	4939				1817		9	1808	670	1138
08225082	Rosenberg	1634				731		5	726	288	438
08225091	Seckach	3113				1145		4	1141	430	711
08225109	Walldürn, Stadt	8946				3028		17	3011	1009	2002
08225113	Zwingenberg	578				273		1	272	122	150
08225114	Ravenstein, Stadt	2307				1274		10	1264	399	865
08225115	Schefflenz	3206				1327		1	1326	525	801
08225116	Schwarzach	2072				653		3	650	275	375
08225117	Elztal	4710				1873		7	1866	664	1202
08225118	Waldbrunn	3802				1468		7	1461	600	861
08226003	Altlußheim	4137				1421		13	1408	775	633
08226006	Bammental	4730				2121		6	2115	1042	1073
08226009	Brühl	11046				4076		18	4058	2068	1990
08226010	Dielheim	6720				2712		11	2701	1049	1652
08226012	Dossenheim	8934				4280		29	4251	2123	2128
08226013	Eberbach, Stadt	10881				3819		24	3795	1788	2007
08226017	Epfenbach	1929				730		12	718	308	410
08226018	Eppelheim, Stadt	10476				4007		33	3974	1967	2007
08226020	Eschelbronn	1898				719		2	717	297	420
08226022	Gaiberg	1750				803		12	791	355	436
08226027	Heddesbach	385				107		0	107	34	73
08226028	Heddesheim	8826				3227		19	3208	1684	1524
08226029	Heiligkreuzsteinach	2126				797		5	792	386	406
08226031	Hemsbach, Stadt	9163				3371		20	3351	1851	1500
08226032	Hockenheim, Stadt	15221				5386		31	5355	2853	2502
08226036	Ilvesheim	6531				2689		15	2674	1452	1222
08226037	Ketsch	9892				3716		23	3693	1843	1850
08226038	Ladenburg, Stadt	8503				3928		23	3905	2082	1823
08226040	Laudenbach	4656				1827		20	1807	945	862
08226041	Leimen, Stadt	19069				5834		32	5802	2801	3001
08226046	Malsch	2711				1197		5	1192	496	696
08226048	Mauer	2982				1332		10	1322	557	765
08226049	Meckesheim	3932				1557		6	1551	657	894
08226054	Mühlhausen	6130				3873		74	3799	1434	2365
08226055	Neckarbischofsheim, Stadt	2874				1006		2	1004	496	508
08226056	Neckargemünd, Stadt	10121				4442		14	4428	2416	2012
08226058	Neidenstein	1407				551		2	549	255	294
08226059	Neulußheim	4713				1721		8	1713	845	868
08226060	Nußloch	8177				3115		15	3100	1389	1711
08226062	Oftersheim	8482				3175		21	3154	1610	1544
08226063	Plankstadt	7378				2788		21	2767	1391	1376
08226065	Rauenberg, Stadt	6076				2283		21	2262	965	1297
08226066	Reichartshausen	1534				541		5	536	199	337
08226068	Reilingen	5391				2002		18	1984	914	1070
08226076	Sandhausen	11020				4114		23	4091	1956	2135
08226080	Schönau, Stadt	3429				1019		8	1011	498	513
08226081	Schönbrunn	2205				948		7	941	391	550
08226082	Schriesheim, Stadt	11209				5115		25	5090	2561	2529
08226084	Schwetzingen, Stadt	15700				5714		29	5685	2985	2700
08226085	Sinsheim, Stadt	25252				8779		32	8747	4033	4714
08226086	Spechbach	1345				587		8	579	251	328
08226091	Waibstadt, Stadt	4144				1492		14	1478	620	858
08226095	Walldorf, Stadt	10194				3932		25	3907	1839	2068
08226096	Weinheim, Stadt	31116				11975		41	11934	6045	5889
08226097	Wiesenbach	2342				1116		6	1110	548	562
08226098	Wiesloch, Stadt	18257				6973		36	6937	3413	3524
08226099	Wilhelmsfeld	2518				1023		2	1021	531	490
08226101	Zuzenhausen	1687				652		4	648	250	398
08226102	Angelbachtal	3720				1446		4	1442	623	819
08226103	St. Leon-Rot	9406				3360		23	3337	1410	1927
08226104	Lobbach	1844				780		2	778	308	470
08226105	Edingen-Neckarhausen	10402				4661		20	4641	2462	2179
08226106	Helmstadt-Bargen	2931				1114		6	1108	448	660
08226107	Hirschberg an der Bergstraße	6901				3374		15	3359	1595	1764
08231000	Pforzheim, Stadt	77648				28791		83	28708	11742	16966
08235006	Altensteig, Stadt	7402				3659		8	3651	1170	2481
08235007	Althengstett	5652				3540		12	3528	1195	2333
08235008	Bad Liebenzell, Stadt	6365				3742		15	3727	1513	2214
08235018	Dobel	1699				693		3	690	258	432
08235020	Ebhausen	3239				1817		9	1808	453	1355
08235022	Egenhausen	1456				774		1	773	217	556
08235025	Enzklösterle	945				514		2	512	148	364
08235029	Gechingen	2676				1800		6	1794	524	1270
08235032	Haiterbach, Stadt	3902				2036		5	2031	419	1612
08235033	Bad Herrenalb, Stadt	5639				2283		10	2273	952	1321
08235035	Höfen an der Enz	1254				570		5	565	191	374
08235046	Nagold, Stadt	15249				7597		23	7574	2286	5288
08235047	Neubulach, Stadt	4055				2399		6	2393	696	1697
08235050	Neuweiler	2437				1432		3	1429	365	1064
08235055	Oberreichenbach	2183				1260		4	1256	431	825
08235057	Ostelsheim	1753				1160		6	1154	379	775
08235060	Rohrdorf	1360				688		1	687	176	511
08235065	Schömberg	5585				2620		8	2612	1070	1542
08235066	Simmersfeld	1515				836		0	836	247	589
08235067	Simmozheim	2101				1211		5	1206	447	759
08235073	Unterreichenbach	1656				788		1	787	351	436
08235079	Bad Wildbad, Stadt	7569				3381		8	3373	1102	2271
08235080	Wildberg, Stadt	7338				4141		12	4129	1149	2980
08235084	Bad Teinach-Zavelstein, Stadt	2286				1319		9	1310	394	916
08235085	Calw, Stadt	14945				7732		23	7709	2711	4998
08236004	Birkenfeld	7577				3685		11	3674	1428	2246
08236011	Eisingen	3452				1520		4	1516	550	966
08236013	Engelsbrand	3361				1700		8	1692	689	1003
08236019	Friolzheim	2627				1559		11	1548	558	990
08236025	Heimsheim, Stadt	3429				1997		6	1991	752	1239
08236028	Illingen	5263				3252		9	3243	1109	2134
08236030	Ispringen	4506				2096		8	2088	879	1209
08236031	Kieselbronn	2305				1190		6	1184	410	774
08236033	Knittlingen, Stadt	5386				2671		11	2660	1002	1658
08236038	Maulbronn, Stadt	4366				2486		13	2473	955	1518
08236039	Mönsheim	1896				1195		4	1191	435	756
08236040	Mühlacker, Stadt	16819				8750		26	8724	2980	5744
08236043	Neuenbürg, Stadt	5577				2631		14	2617	1099	1518
08236044	Neuhausen	4008				2211		5	2206	694	1512
08236046	Niefern-Öschelbronn	8448				3886		17	3869	1465	2404
08236050	Ötisheim	3536				1957		10	1947	554	1393
08236061	Sternenfels	2069				1117		3	1114	433	681
08236062	Tiefenbronn	3910				2384		11	2373	820	1553
08236065	Wiernsheim	4783				2661		12	2649	913	1736
08236067	Wimsheim	1978				1104		4	1100	376	724
08236068	Wurmberg	2168				1065		6	1059	391	668
08236070	Keltern	7116				3512		19	3493	1346	2147
08236071	Remchingen	8853				3941		23	3918	1396	2522
08236072	Straubenhardt	8196				3713		14	3699	1581	2118
08236073	Neulingen	5008				2332		5	2327	922	1405
08236074	Kämpfelbach	4853				2357		13	2344	816	1528
08236075	Ölbronn-Dürrn	2596				1288		5	1283	450	833
08236076	Königsbach-Stein	7567				3516		16	3500	1315	2185
08237002	Alpirsbach, Stadt	4944				2354		9	2345	868	1477
08237004	Baiersbronn	11259				5058		22	5036	1452	3584
08237019	Dornstetten, Stadt	5883				2437		7	2430	883	1547
08237024	Empfingen	2993				1527		7	1520	376	1144
08237027	Eutingen im Gäu	3985				2237		7	2230	612	1618
08237028	Freudenstadt, Stadt	16399				7320		39	7281	2620	4661
08237030	Glatten	1864				851		5	846	241	605
08237032	Grömbach	500				261		0	261	84	177
08237040	Horb am Neckar, Stadt	18159				9591		33	9558	2966	6592
08237045	Loßburg	5894				2983		5	2978	1073	1905
08237054	Pfalzgrafenweiler	4903				2444		16	2428	706	1722
08237061	Schopfloch	1931				1000		2	998	232	766
08237072	Wörnersberg	166				88		2	86	15	71
08237073	Seewald	1744				855		5	850	217	633
08237074	Waldachtal	4503				2205		18	2187	553	1634
08237075	Bad Rippoldsau-Schapbach	1760				798		1	797	322	475
08311000	Freiburg im Breisgau, Stadt	148642				66350		381	65969	43839	22130
08315003	Au	1055				554		8	546	311	235
08315004	Auggen	1815				718		3	715	369	346
08315006	Bad Krozingen, Stadt	13075				5126		28	5098	2677	2421
08315007	Badenweiler	2974				1352		3	1349	780	569
08315008	Ballrechten-Dottingen	1748				1162		10	1152	482	670
08315013	Bötzingen	3744				1547		6	1541	673	868
08315014	Bollschweil	1730				866		5	861	482	379
08315015	Breisach am Rhein, Stadt	10356				4029		21	4008	2049	1959
08315016	Breitnau	1274				555		4	551	224	327
08315020	Buchenbach	2321				1155		5	1150	639	511
08315022	Buggingen	2929				1131		3	1128	698	430
08315028	Ebringen	2149				985		9	976	519	457
08315030	Eichstetten am Kaiserstuhl	2435				1103		8	1095	501	594
08315031	Eisenbach (Hochschwarzwald)	1583				693		0	693	270	423
08315033	Eschbach	1701				650		2	648	325	323
08315037	Feldberg (Schwarzwald)	1324				771		4	767	298	469
08315039	Friedenweiler	1526				712		1	711	260	451
08315041	Glottertal	2368				861		7	854	357	497
08315043	Gottenheim	2047				885		5	880	447	433
08315047	Gundelfingen	8819				4357		22	4335	2557	1778
08315048	Hartheim	3421				1317		6	1311	590	721
08315050	Heitersheim, Stadt	4299				1918		14	1904	973	931
08315051	Heuweiler	834				407		4	403	168	235
08315052	Hinterzarten	1787				834		2	832	369	463
08315056	Horben	768				350		1	349	197	152
08315059	Ihringen	4608				2147		10	2137	1087	1050
08315064	Kirchzarten	7382				3661		21	3640	2201	1439
08315068	Lenzkirch	3741				1412		5	1407	558	849
08315070	Löffingen, Stadt	5748				2505		13	2492	973	1519
08315072	Merdingen	1998				714		6	708	317	391
08315073	Merzhausen	3795				2056		6	2050	1246	804
08315074	Müllheim, Stadt	13297				5327		16	5311	3006	2305
08315076	Neuenburg am Rhein, Stadt	8609				2865		11	2854	1408	1446
08315084	Oberried	2112				974		6	968	474	494
08315089	Pfaffenweiler	1975				872		3	869	421	448
08315094	St. Märgen	1392				568		3	565	226	339
08315095	St. Peter	1950				784		4	780	355	425
08315098	Schallstadt	4537				2206		13	2193	1358	835
08315102	Schluchsee	1861				747		6	741	253	488
08315107	Sölden	931				492		2	490	278	212
08315108	Staufen im Breisgau, Stadt	5514				2804		14	2790	1665	1125
08315109	Stegen	3296				1520		7	1513	813	700
08315111	Sulzburg, Stadt	2008				1296		12	1284	707	577
08315113	Titisee-Neustadt, Stadt	8747				3390		22	3368	1417	1951
08315115	Umkirch	3908				1475		9	1466	831	635
08315125	Wittnau	1111				598		5	593	327	266
08315130	Münstertal/Schwarzwald	3915				1410		6	1404	685	719
08315131	Ehrenkirchen	5533				2470		16	2454	1265	1189
08315132	March	6739				3032		16	3016	1840	1176
08315133	Vogtsburg im Kaiserstuhl, Stadt	4545				1962		11	1951	766	1185
08316002	Bahlingen am Kaiserstuhl	3075				1194		8	1186	649	537
08316003	Biederbach	1360				355		2	353	143	210
08316009	Denzlingen	10250				4619		56	4563	2724	1839
08316010	Elzach, Stadt	5576				2094		17	2077	955	1122
08316011	Emmendingen, Stadt	19637				8073		57	8016	4760	3256
08316012	Endingen am Kaiserstuhl, Stadt	7031				3002		15	2987	1425	1562
08316013	Forchheim	1020				297		5	292	145	147
08316014	Gutach im Breisgau	3248				1340		14	1326	643	683
08316017	Herbolzheim, Stadt	7625				3092		14	3078	1784	1294
08316020	Kenzingen, Stadt	6992				2916		7	2909	1690	1219
08316024	Malterdingen	2334				831		2	829	440	389
08316036	Reute	2393				1018		3	1015	619	396
08316037	Riegel am Kaiserstuhl	2816				1038		12	1026	525	501
08316038	Sasbach am Kaiserstuhl	2582				1023		11	1012	535	477
08316039	Sexau	2472				1106		4	1102	599	503
08316042	Simonswald	2378				919		7	912	394	518
08316043	Teningen	9046				3728		21	3707	2043	1664
08316045	Vörstetten	2272				1219		7	1212	762	450
08316049	Weisweil	1664				687		2	685	423	262
08316051	Wyhl am Kaiserstuhl	2814				956		11	945	491	454
08316053	Rheinhausen	2696				1101		5	1096	434	662
08316054	Freiamt	3325				1206		11	1195	551	644
08316055	Winden im Elztal	2221				886		0	886	485	401
08316056	Waldkirch, Stadt	15450				6556		24	6532	3673	2859
08317001	Achern, Stadt	18682				7281		26	7255	3043	4212
08317005	Appenweier	7641				2893		25	2868	1273	1595
08317008	Bad Peterstal-Griesbach	2116				893		9	884	264	620
08317009	Berghaupten	1867				760		5	755	319	436
08317011	Biberach	2790				1170		11	1159	477	682
08317021	Durbach	3060				1400		8	1392	534	858
08317026	Ettenheim, Stadt	9413				3867		23	3844	1620	2224
08317029	Fischerbach	1335				593		6	587	230	357
08317031	Friesenheim	9845				3822		18	3804	1651	2153
08317034	Gengenbach, Stadt	8396				3120		17	3103	1464	1639
08317039	Gutach (Schwarzwaldbahn)	1756				794		1	793	328	465
08317040	Haslach im Kinzigtal, Stadt	5250				2122		16	2106	948	1158
08317041	Hausach, Stadt	4452				1879		9	1870	805	1065
08317046	Hofstetten	1288				560		3	557	160	397
08317047	Hohberg	6222				2573		16	2557	1134	1423
08317051	Hornberg, Stadt	3029				1218		9	1209	476	733
08317056	Kappelrodeck	4536				1812		12	1800	606	1194
08317057	Kehl, Stadt	23950				7685		27	7658	3784	3874
08317059	Kippenheim	4045				1614		16	1598	709	889
08317065	Lahr/Schwarzwald, Stadt	31574				9554		65	9489	4500	4989
08317067	Lautenbach	1513				621		2	619	216	403
08317068	Lauf	3100				1218		7	1211	502	709
08317073	Mahlberg, Stadt	3551				1176		10	1166	567	599
08317075	Meißenheim	2924				1177		1	1176	435	741
08317078	Mühlenbach	1289				455		1	454	160	294
08317085	Nordrach	1516				534		0	534	186	348
08317088	Oberharmersbach	1920				833		6	827	272	555
08317089	Oberkirch, Stadt	15273				6405		30	6375	2317	4058
08317093	Oberwolfach	2053				939		3	936	399	537
08317096	Offenburg, Stadt	43297				15899		86	15813	8554	7259
08317097	Ohlsbach	2471				1122		10	1112	544	568
08317098	Oppenau, Stadt	3708				1639		5	1634	642	992
08317100	Ortenberg	2598				1191		9	1182	565	617
08317102	Ottenhöfen im Schwarzwald	2463				964		4	960	277	683
08317110	Renchen, Stadt	5581				1973		7	1966	829	1137
08317113	Ringsheim	1733				729		2	727	307	420
08317114	Rust	2760				862		5	857	335	522
08317116	Sasbach	4097				1574		12	1562	586	976
08317118	Sasbachwalden	1827				711		2	709	244	465
08317121	Schuttertal	2530				972		12	960	251	709
08317122	Schutterwald	5688				2414		19	2395	1187	1208
08317126	Seebach	1109				477		5	472	131	341
08317127	Seelbach	3945				1665		11	1654	684	970
08317129	Steinach	3114				1175		9	1166	550	616
08317141	Willstätt	6917				2513		6	2507	1175	1332
08317145	Wolfach, Stadt	4497				2035		7	2028	831	1197
08317146	Zell am Harmersbach, Stadt	6222				2212		18	2194	906	1288
08317150	Schwanau	5249				2199		9	2190	780	1410
08317151	Neuried	7325				2362		10	2352	1020	1332
08317152	Kappel-Grafenhausen	3712				1278		7	1271	520	751
08317153	Rheinau, Stadt	8555				3157		13	3144	1344	1800
08325001	Aichhalden	3216				1615		11	1604	477	1127
08325009	Bösingen	2553				1364		5	1359	381	978
08325011	Dietingen	3030				1629		21	1608	495	1113
08325012	Dornhan, Stadt	4772				2529		9	2520	828	1692
08325014	Dunningen	4642				2395		10	2385	771	1614
08325015	Epfendorf	2610				1386		5	1381	415	966
08325024	Hardt	2004				1025		4	1021	428	593
08325036	Lauterbach	2344				1098		4	1094	332	762
08325045	Oberndorf am Neckar, Stadt	10237				4830		11	4819	1761	3058
08325049	Rottweil, Stadt	18043				8561		39	8522	3274	5248
08325050	Schenkenzell	1444				655		3	652	219	433
08325051	Schiltach, Stadt	3089				1347		8	1339	615	724
08325053	Schramberg, Stadt	15714				6502		36	6466	2585	3881
08325057	Sulz am Neckar, Stadt	9048				4546		17	4529	1380	3149
08325060	Villingendorf	2431				1236		6	1230	408	822
08325061	Vöhringen	3280				1497		3	1494	358	1136
08325064	Wellendingen	2180				1073		3	1070	277	793
08325069	Zimmern ob Rottweil	4484				2243		10	2233	802	1431
08325070	Fluorn-Winzeln	2325				1152		4	1148	386	762
08325071	Eschbronn	1594				816		8	808	330	478
08325072	Deißlingen	4520				2095		11	2084	779	1305
08326003	Bad Dürrheim, Stadt	9765				4188		20	4168	1564	2604
08326005	Blumberg, Stadt	7303				2767		21	2746	919	1827
08326006	Bräunlingen, Stadt	4356				1934		9	1925	736	1189
08326010	Dauchingen	2864				1344		2	1342	508	834
08326012	Donaueschingen, Stadt	15746				6430		23	6407	2590	3817
08326017	Furtwangen im Schwarzwald, Stadt	6005				2584		4	2580	1214	1366
08326020	Gütenbach	966				373		2	371	178	193
08326027	Hüfingen, Stadt	5434				2430		7	2423	820	1603
08326031	Königsfeld im Schwarzwald	4593				2419		3	2416	1133	1283
08326037	Mönchweiler	2337				1023		0	1023	450	573
08326041	Niedereschach	4508				1998		8	1990	789	1201
08326052	St. Georgen im Schwarzwald, Stadt	9489				4416		23	4393	1946	2447
08326054	Schönwald im Schwarzwald	1862				727		2	725	256	469
08326055	Schonach im Schwarzwald	3212				1334		11	1323	463	860
08326060	Triberg im Schwarzwald, Stadt	3551				1292		9	1283	431	852
08326061	Tuningen	2147				995		5	990	354	636
08326065	Unterkirnach	1816				751		3	748	268	480
08326068	Vöhrenbach, Stadt	2796				1023		5	1018	416	602
08326074	Villingen-Schwenningen, Stadt	56873				21857		82	21775	9647	12128
08326075	Brigachtal	3973				1737		6	1731	680	1051
08327002	Aldingen	5384				2194		7	2187	715	1472
08327004	Bärenthal	373				195		3	192	38	154
08327005	Balgheim	824				388		0	388	94	294
08327006	Böttingen	1072				523		0	523	101	422
08327007	Bubsheim	802				344		2	342	67	275
08327008	Buchheim	524				287		2	285	49	236
08327009	Deilingen	1276				748		8	740	172	568
08327010	Denkingen	1916				945		2	943	309	634
08327011	Dürbheim	1274				671		3	668	166	502
08327012	Durchhausen	700				311		1	310	92	218
08327013	Egesheim	481				195		2	193	18	175
08327016	Fridingen an der Donau, Stadt	2410				1266		5	1261	429	832
08327017	Frittlingen	1511				764		6	758	208	550
08327018	Geisingen, Stadt	4479				1759		2	1757	518	1239
08327019	Gosheim	2719				1220		5	1215	259	956
08327020	Gunningen	533				225		0	225	72	153
08327023	Hausen ob Verena	608				277		1	276	105	171
08327025	Immendingen	4318				1842		5	1837	593	1244
08327027	Irndorf	569				291		2	289	70	219
08327029	Königsheim	430				199		0	199	37	162
08327030	Kolbingen	1003				559		2	557	127	430
08327033	Mahlstetten	608				324		1	323	86	237
08327036	Mühlheim an der Donau, Stadt	2548				1467		4	1463	454	1009
08327038	Neuhausen ob Eck	2733				1281		5	1276	412	864
08327040	Reichenbach am Heuberg	346				150		0	150	22	128
08327041	Renquishausen	573				341		2	339	64	275
08327046	Spaichingen, Stadt	9005				4108		5	4103	1288	2815
08327048	Talheim	942				468		0	468	166	302
08327049	Trossingen, Stadt	10845				4248		19	4229	1630	2599
08327050	Tuttlingen, Stadt	22534				9635		19	9616	3651	5965
08327051	Wehingen	2344				1015		3	1012	244	768
08327054	Wurmlingen	2957				1574		12	1562	507	1055
08327055	Seitingen-Oberflacht	1734				929		2	927	266	661
08327056	Rietheim-Weilheim	1998				1012		3	1009	271	738
08327057	Emmingen-Liptingen	3398				1511		7	1504	424	1080
08335001	Aach, Stadt	1646				680		5	675	316	359
08335002	Allensbach	5482				2798		29	2769	1580	1189
08335015	Büsingen am Hochrhein	782				312		1	311	152	159
08335021	Eigeltingen	2786				1237		0	1237	482	755
08335022	Engen, Stadt	7519				3377		12	3365	1429	1936
08335025	Gaienhofen	2510				1259		9	1250	587	663
08335026	Gailingen am Hochrhein	2022				845		5	840	439	401
08335028	Gottmadingen	7413				3058		5	3053	1513	1540
08335035	Hilzingen	6245				2831		10	2821	1123	1698
08335043	Konstanz, Universitätsstadt	58711				27032		210	26822	15146	11676
08335055	Moos	2506				1322		6	1316	675	641
08335057	Mühlingen	1719				634		3	631	243	388
08335061	Öhningen	2743				1322		7	1315	658	657
08335063	Radolfzell am Bodensee, Stadt	22357				10494		85	10409	5441	4968
08335066	Reichenau	3916				1934		14	1920	935	985
08335075	Singen (Hohentwiel), Stadt	30232				10191		47	10144	4730	5414
08335077	Steißlingen	3486				1657		11	1646	714	932
08335079	Stockach, Stadt	12096				4983		25	4958	2129	2829
08335080	Tengen, Stadt	3573				1642		6	1636	644	992
08335081	Volkertshausen	2101				975		4	971	425	546
08335096	Hohenfels	1456				725		1	724	283	441
08335097	Mühlhausen-Ehingen	2793				1240		5	1235	498	737
08335098	Bodman-Ludwigshafen	3347				1490		1	1489	668	821
08335099	Orsingen-Nenzingen	2389				1124		5	1119	437	682
08335100	Rielasingen-Worblingen	8819				3532		19	3513	1654	1859
08336004	Aitern	417				169		3	166	67	99
08336006	Bad Bellingen	3059				1122		2	1120	493	627
08336008	Binzen	2165				1023		10	1013	555	458
08336010	Böllen	75				36		0	36	13	23
08336014	Efringen-Kirchen	6411				2945		18	2927	1489	1438
08336019	Eimeldingen	1825				723		6	717	458	259
08336024	Fischingen	523				193		1	192	111	81
08336025	Fröhnd	384				143		4	139	50	89
08336034	Hasel	885				260		3	257	134	123
08336036	Hausen im Wiesental	1680				758		3	755	415	340
08336043	Inzlingen	1900				927		4	923	445	478
08336045	Kandern, Stadt	5991				2574		34	2540	1413	1127
08336050	Lörrach, Stadt	33750				12150		64	12086	6757	5329
08336057	Maulburg	3007				1239		4	1235	677	558
08336069	Rheinfelden (Baden), Stadt	22652				7832		43	7789	4031	3758
08336073	Rümmingen	1262				509		2	507	263	244
08336075	Schallbach	571				254		2	252	100	152
08336078	Schliengen	3997				1747		16	1731	846	885
08336079	Schönau im Schwarzwald, Stadt	1648				694		4	690	323	367
08336080	Schönenberg	280				119		0	119	68	51
08336081	Schopfheim, Stadt	13931				5363		41	5322	3047	2275
08336082	Schwörstadt	1808				670		2	668	307	361
08336084	Steinen	7472				3092		13	3079	1768	1311
08336087	Todtnau, Stadt	3578				1516		11	1505	655	850
08336089	Tunau	150				75		3	72	23	49
08336090	Utzenfeld	500				166		1	165	89	76
08336091	Weil am Rhein, Stadt	20515				6484		30	6454	3645	2809
08336094	Wembach	250				122		2	120	54	66
08336096	Wieden	449				196		3	193	47	146
08336100	Wittlingen	699				259		2	257	137	120
08336103	Zell im Wiesental, Stadt	4203				1692		11	1681	863	818
08336104	Malsburg-Marzell	1109				469		2	467	269	198
08336105	Grenzach-Wyhlen	10241				3795		33	3762	2046	1716
08336106	Häg-Ehrsberg	681				283		2	281	99	182
08336107	Kleines Wiesental	2296				898		2	896	482	414
08337002	Albbruck	5252				1972		6	1966	829	1137
08337013	Bernau im Schwarzwald	1364				663		3	660	270	390
08337022	Bonndorf im Schwarzwald, Stadt	4989				1936		5	1931	752	1179
08337027	Dachsberg (Südschwarzwald)	1010				525		0	525	231	294
08337030	Dettighofen	811				309		1	308	155	153
08337032	Dogern	1774				803		3	800	320	480
08337038	Görwihl	3261				1439		6	1433	516	917
08337039	Grafenhausen	1595				723		2	721	263	458
08337045	Häusern	933				409		4	405	145	260
08337049	Herrischried	1899				705		3	702	334	368
08337051	Höchenschwand	1763				676		2	674	251	423
08337053	Hohentengen am Hochrhein	2504				1042		7	1035	415	620
08337059	Ibach	313				138		0	138	58	80
08337060	Jestetten	3337				1175		2	1173	555	618
08337062	Klettgau	5200				2181		16	2165	1010	1155
08337065	Lauchringen	5172				2105		13	2092	859	1233
08337066	Laufenburg (Baden), Stadt	5947				2121		13	2108	1019	1089
08337070	Lottstetten	1387				502		3	499	234	265
08337076	Murg	4635				1707		12	1695	783	912
08337090	Rickenbach	2890				1199		11	1188	579	609
08337096	Bad Säckingen, Stadt	11845				4398		24	4374	2259	2115
08337097	St. Blasien, Stadt	2555				919		2	917	343	574
08337106	Stühlingen, Stadt	3848				1802		9	1793	655	1138
08337108	Todtmoos	1394				505		1	504	222	282
08337116	Wehr, Stadt	9150				3320		25	3295	1774	1521
08337118	Weilheim	2396				1151		11	1140	431	709
08337123	Wutöschingen	4648				1721		9	1712	671	1041
08337124	Eggingen	1239				525		2	523	186	337
08337125	Küssaberg	4018				1677		5	1672	759	913
08337126	Waldshut-Tiengen, Stadt	16413				6147		35	6112	2812	3300
08337127	Wutach	923				523		0	523	185	338
08337128	Ühlingen-Birkendorf	3939				1548		16	1532	600	932
08415014	Dettingen an der Erms	6520				3541		10	3531	1241	2290
08415019	Eningen unter Achalm	7845				4550		16	4534	1771	2763
08415027	Gomadingen	1703				963		3	960	418	542
08415028	Grabenstetten	1197				580		3	577	182	395
08415029	Grafenberg	1963				1244		4	1240	381	859
08415034	Hayingen, Stadt	1660				1039		2	1037	223	814
08415039	Hülben	2175				1225		7	1218	342	876
08415048	Mehrstetten	1054				552		0	552	171	381
08415050	Metzingen, Stadt	15451				8438		39	8399	3221	5178
08415053	Münsingen, Stadt	10709				5262		20	5242	1674	3568
08415058	Pfronstetten	1327				792		6	786	133	653
08415059	Pfullingen, Stadt	12801				6683		21	6662	2608	4054
08415060	Pliezhausen	7028				4512		15	4497	1662	2835
08415061	Reutlingen, Stadt	75843				38405		128	38277	16561	21716
08415062	Riederich	3064				1762		4	1758	624	1134
08415073	Trochtelfingen, Stadt	4765				2632		7	2625	755	1870
08415078	Bad Urach, Stadt	8384				4430		19	4411	1581	2830
08415080	Wannweil	3768				2209		3	2206	931	1275
08415085	Zwiefalten	1694				922		3	919	193	726
08415087	Walddorfhäslach	3617				2288		6	2282	725	1557
08415088	Römerstein	3063				1953		6	1947	481	1466
08415089	Engstingen	3976				2419		8	2411	727	1684
08415090	Hohenstein	2754				1737		14	1723	447	1276
08415091	Sonnenbühl	5380				3109		10	3099	832	2267
08415092	Lichtenstein	6444				3399		25	3374	1099	2275
08415093	St. Johann	4050				2536		9	2527	873	1654
08416006	Bodelshausen	3842				1792		11	1781	724	1057
08416009	Dettenhausen	4001				2557		5	2552	940	1612
08416011	Dußlingen	3931				2061		10	2051	815	1236
08416015	Gomaringen	6239				3506		18	3488	1483	2005
08416018	Hirrlingen	2237				1198		4	1194	356	838
08416022	Kirchentellinsfurt	4083				2476		6	2470	1142	1328
08416023	Kusterdingen	6087				3892		24	3868	1860	2008
08416025	Mössingen, Stadt	14165				7372		21	7351	3137	4214
08416026	Nehren	3015				1603		12	1591	732	859
08416031	Ofterdingen	3272				1782		5	1777	708	1069
08416036	Rottenburg am Neckar, Stadt	29712				16650		60	16590	6468	10122
08416041	Tübingen, Universitätsstadt	59501				37047		201	36846	21274	15572
08416048	Ammerbuch	8159				5210		25	5185	2249	2936
08416049	Neustetten	2449				1444		5	1439	420	1019
08416050	Starzach	3246				1815		10	1805	692	1113
08417002	Balingen, Stadt	25862				12454		29	12425	4733	7692
08417008	Bisingen	6891				3313		26	3287	1252	2035
08417010	Bitz	2934				1352		9	1343	443	900
08417013	Burladingen, Stadt	9111				4599		16	4583	1235	3348
08417014	Dautmergen	316				152		1	151	43	108
08417015	Dormettingen	771				436		0	436	118	318
08417016	Dotternhausen	1363				771		3	768	233	535
08417022	Geislingen, Stadt	4677				2472		17	2455	653	1802
08417023	Grosselfingen	1595				644		0	644	242	402
08417025	Haigerloch, Stadt	7933				4032		4	4028	1169	2859
08417029	Hausen am Tann	366				157		0	157	42	115
08417031	Hechingen, Stadt	13771				6085		21	6064	2373	3691
08417036	Jungingen	1090				560		0	560	226	334
08417044	Meßstetten, Stadt	7986				4050		11	4039	1371	2668
08417045	Nusplingen	1443				811		1	810	146	664
08417047	Obernheim	1114				480		0	480	112	368
08417051	Rangendingen	3946				1765		5	1760	500	1260
08417052	Ratshausen	606				330		2	328	109	219
08417054	Rosenfeld, Stadt	4806				2425		11	2414	828	1586
08417057	Schömberg, Stadt	3228				1611		3	1608	456	1152
08417063	Straßberg	2016				1042		5	1037	305	732
08417071	Weilen unter den Rinnen	446				269		2	267	71	196
08417075	Winterlingen	4802				2314		7	2307	734	1573
08417078	Zimmern unter der Burg	369				178		2	176	59	117
08417079	Albstadt, Stadt	32350				14174		47	14127	4672	9455
08421000	Ulm, Universitätsstadt	80823				42129		96	42033	12971	29062
08425002	Allmendingen	3263				1866		3	1863	294	1569
08425004	Altheim	426				222		0	222	26	196
08425005	Altheim (Alb)	1330				708		0	708	159	549
08425008	Amstetten	2734				1418		8	1410	397	1013
08425011	Asselfingen	782				433		3	430	106	324
08425013	Ballendorf	511				301		1	300	49	251
08425014	Beimerstetten	1900				952		1	951	245	706
08425017	Berghülen	1454				907		6	901	203	698
08425019	Bernstadt	1721				776		2	774	138	636
08425020	Blaubeuren, Stadt	8331				4706		52	4654	1446	3208
08425022	Börslingen	129				79		0	79	12	67
08425024	Breitingen	216				106		0	106	22	84
08425028	Dietenheim, Stadt	4684				1897		8	1889	466	1423
08425031	Dornstadt	6492				3689		6	3683	1014	2669
08425033	Ehingen (Donau), Stadt	17317				8974		63	8911	1689	7222
08425035	Emeringen	118				95		1	94	15	79
08425036	Emerkingen	598				343		2	341	44	297
08425039	Erbach, Stadt	9800				5425		12	5413	1221	4192
08425050	Griesingen	765				404		1	403	65	338
08425052	Grundsheim	151				102		0	102	5	97
08425055	Hausen am Bussen	203				127		1	126	18	108
08425062	Holzkirch	212				110		0	110	10	100
08425064	Hüttisheim	1044				537		1	536	74	462
08425066	Illerrieden	2594				1377		5	1372	336	1036
08425071	Laichingen, Stadt	7793				4311		31	4280	1027	3253
08425072	Langenau, Stadt	10220				5433		11	5422	1512	3910
08425073	Lauterach	425				248		2	246	25	221
08425075	Lonsee	3539				2119		4	2115	598	1517
08425079	Merklingen	1452				754		2	752	229	523
08425081	Munderkingen, Stadt	3640				1694		3	1691	350	1341
08425083	Neenstetten	607				347		1	346	85	261
08425084	Nellingen	1392				811		3	808	187	621
08425085	Nerenstetten	270				151		0	151	26	125
08425088	Oberdischingen	1529				746		1	745	145	600
08425090	Obermarchtal	932				546		1	545	70	475
08425091	Oberstadion	1176				650		1	649	85	564
08425092	Öllingen	380				205		1	204	37	167
08425093	Öpfingen	1699				770		3	767	168	599
08425097	Rammingen	962				462		0	462	94	368
08425098	Rechtenstein	244				158		0	158	25	133
08425104	Rottenacker	1573				766		0	766	136	630
08425108	Schelklingen, Stadt	4959				2742		20	2722	516	2206
08425110	Schnürpflingen	1023				513		0	513	104	409
08425112	Setzingen	503				248		2	246	44	202
08425123	Untermarchtal	729				400		4	396	60	336
08425124	Unterstadion	576				351		0	351	35	316
08425125	Unterwachingen	138				96		1	95	14	81
08425130	Weidenstetten	954				488		2	486	110	376
08425134	Westerheim	2243				1200		7	1193	265	928
08425135	Westerstetten	1675				857		0	857	210	647
08425137	Illerkirchberg	3544				1887		7	1880	413	1467
08425138	Staig	2455				1304		2	1302	265	1037
08425139	Heroldstatt	2072				1190		2	1188	232	956
08425140	Balzheim	1414				601		4	597	132	465
08425141	Blaustein	11268				6434		17	6417	1686	4731
08426001	Achstetten	3079				1798		8	1790	299	1491
08426005	Alleshausen	379				228		1	227	25	202
08426006	Allmannsweiler	236				127		0	127	25	102
08426008	Altheim	1683				904		2	902	211	691
08426011	Attenweiler	1382				728		2	726	109	617
08426013	Bad Buchau, Stadt	3173				1356		8	1348	377	971
08426014	Bad Schussenried, Stadt	6205				2819		11	2808	824	1984
08426019	Berkheim	1998				907		2	905	258	647
08426020	Betzenweiler	564				307		0	307	59	248
08426021	Biberach an der Riß, Stadt	23596				11652		33	11619	3795	7824
08426028	Burgrieden	2725				1400		2	1398	238	1160
08426031	Dettingen an der Iller	1715				747		1	746	179	567
08426035	Dürmentingen	1988				1026		6	1020	167	853
08426036	Dürnau	348				175		2	173	38	135
08426038	Eberhardzell	3235				1615		7	1608	332	1276
08426043	Erlenmoos	1258				549		5	544	117	427
08426044	Erolzheim	2349				1031		2	1029	249	780
08426045	Ertingen	4123				1840		2	1838	392	1446
08426058	Hochdorf	1647				972		3	969	228	741
08426062	Ingoldingen	2120				1188		3	1185	253	932
08426064	Kanzach	400				203		0	203	54	149
08426065	Kirchberg an der Iller	1469				771		0	771	205	566
08426066	Kirchdorf an der Iller	2514				982		3	979	248	731
08426067	Langenenslingen	2640				1485		9	1476	311	1165
08426070	Laupheim, Stadt	14542				7202		15	7187	1636	5551
08426071	Maselheim	3363				1829		0	1829	395	1434
08426073	Mietingen	3147				1769		5	1764	302	1462
08426074	Mittelbiberach	3054				1805		2	1803	540	1263
08426078	Moosburg	190				111		2	109	29	80
08426087	Ochsenhausen, Stadt	6335				3013		4	3009	773	2236
08426090	Oggelshausen	719				365		2	363	59	304
08426097	Riedlingen, Stadt	7635				3592		11	3581	969	2612
08426100	Rot an der Rot	3344				1434		5	1429	342	1087
08426108	Schwendi	4769				2399		7	2392	490	1902
08426109	Seekirch	137				132		0	132	22	110
08426113	Steinhausen an der Rottum	1517				823		1	822	171	651
08426117	Tannheim	1772				671		3	668	227	441
08426118	Tiefenbach	387				224		2	222	65	157
08426120	Ummendorf	3340				1990		12	1978	485	1493
08426121	Unlingen	1813				1083		9	1074	217	857
08426124	Uttenweiler	2911				1607		7	1600	300	1300
08426125	Wain	1130				560		2	558	114	444
08426128	Warthausen	3909				2229		8	2221	588	1633
08426134	Schemmerhofen	5940				3309		6	3303	609	2694
08426135	Gutenzell-Hürbel	1378				687		2	685	146	539
08435005	Bermatingen	2615				1448		1	1447	655	792
08435010	Daisendorf	1195				722		2	720	327	393
08435013	Eriskirch	3370				1598		4	1594	578	1016
08435015	Frickingen	2168				1047		4	1043	431	612
08435016	Friedrichshafen, Stadt	41455				17480		47	17433	7056	10377
08435018	Hagnau am Bodensee	1100				614		1	613	213	400
08435020	Heiligenberg	2196				1157		6	1151	593	558
08435024	Immenstaad am Bodensee	4819				2606		10	2596	1118	1478
08435029	Kressbronn am Bodensee	6034				2843		9	2834	1140	1694
08435030	Langenargen	5854				3000		9	2991	1178	1813
08435034	Markdorf, Stadt	9567				4543		15	4528	2048	2480
08435035	Meckenbeuren	9899				4394		9	4385	1657	2728
08435036	Meersburg, Stadt	4073				1978		3	1975	889	1086
08435042	Neukirch	1949				871		5	866	305	561
08435045	Oberteuringen	3349				1587		3	1584	557	1027
08435047	Owingen	3150				1637		6	1631	735	896
08435052	Salem	8199				4249		16	4233	1882	2351
08435053	Sipplingen	1669				872		4	868	373	495
08435054	Stetten	762				401		2	399	175	224
08435057	Tettnang, Stadt	13683				6265		19	6246	2444	3802
08435059	Überlingen, Stadt	16709				8216		29	8187	4129	4058
08435066	Uhldingen-Mühlhofen	5748				2752		7	2745	1340	1405
08435067	Deggenhausertal	3164				1601		1	1600	600	1000
08436001	Achberg	1211				493		2	491	205	286
08436003	Aichstetten	2012				889		5	884	346	538
08436004	Aitrach	1886				783		2	781	275	506
08436005	Altshausen	3130				1011		0	1011	273	738
08436006	Amtzell	2933				1422		5	1417	555	862
08436008	Aulendorf, Stadt	7333				3153		12	3141	1280	1861
08436009	Bad Waldsee, Stadt	14701				6831		38	6793	2315	4478
08436010	Bad Wurzach, Stadt	10189				4523		14	4509	1501	3008
08436011	Baienfurt	5153				2250		3	2247	764	1483
08436012	Baindt	3738				1798		4	1794	637	1157
08436013	Berg	3090				1598		3	1595	551	1044
08436014	Bergatreute	2439				1149		6	1143	420	723
08436018	Bodnegg	2413				1097		5	1092	454	638
08436019	Boms	446				170		1	169	45	124
08436024	Ebenweiler	906				393		1	392	124	268
08436027	Eichstegen	390				189		0	189	27	162
08436032	Fleischwangen	484				217		0	217	61	156
08436039	Grünkraut	2265				1176		2	1174	525	649
08436040	Guggenhausen	138				81		0	81	25	56
08436047	Hoßkirch	596				253		0	253	71	182
08436049	Isny im Allgäu, Stadt	9890				3935		12	3923	1764	2159
08436052	Kißlegg	6559				2988		16	2972	1279	1693
08436053	Königseggwald	508				236		3	233	65	168
08436055	Leutkirch im Allgäu, Stadt	16425				7266		30	7236	2841	4395
08436064	Ravensburg, Stadt	35557				16591		56	16535	7212	9323
08436067	Riedhausen	491				258		0	258	65	193
08436069	Schlier	2839				1574		5	1569	592	977
08436077	Unterwaldhausen	201				117		0	117	46	71
08436078	Vogt	3363				1502		2	1500	661	839
08436079	Waldburg	2321				1171		5	1166	506	660
08436081	Wangen im Allgäu, Stadt	19685				8774		28	8746	3941	4805
08436082	Weingarten, Stadt	17338				7358		19	7339	3109	4230
08436083	Wilhelmsdorf	3368				1729		7	1722	752	970
08436085	Wolfegg	2642				1314		9	1305	526	779
08436087	Wolpertswende	3044				1571		7	1564	447	1117
08436093	Ebersbach-Musbach	1296				595		2	593	181	412
08436094	Argenbühl	4618				2000		14	1986	801	1185
08436095	Horgenzell	3513				1891		16	1875	613	1262
08436096	Fronreute	3413				1792		11	1781	632	1149
08437005	Beuron	560				298		0	298	136	162
08437008	Bingen	2092				1137		3	1134	404	730
08437031	Gammertingen, Stadt	4628				2334		5	2329	707	1622
08437044	Herbertingen	3642				1658		7	1651	409	1242
08437047	Hettingen, Stadt	1437				891		7	884	170	714
08437053	Hohentengen	3126				1648		3	1645	415	1230
08437056	Illmensee	1527				768		3	765	324	441
08437059	Inzigkofen	2148				1119		8	1111	363	748
08437065	Krauchenwies	3756				1895		9	1886	565	1321
08437072	Leibertingen	1697				934		3	931	233	698
08437076	Mengen, Stadt	7513				3496		28	3468	955	2513
08437078	Meßkirch, Stadt	6088				2474		4	2470	752	1718
08437082	Neufra	1455				747		3	744	194	550
08437086	Ostrach	5229				2396		6	2390	713	1677
08437088	Pfullendorf, Stadt	9093				3337		15	3322	1182	2140
08437100	Bad Saulgau, Stadt	12784				6017		56	5961	1942	4019
08437101	Scheer, Stadt	1921				903		4	899	311	588
08437102	Schwenningen	1258				688		7	681	149	532
08437104	Sigmaringen, Stadt	11622				5386		15	5371	2249	3122
08437105	Sigmaringendorf	2717				1419		10	1409	529	880
08437107	Stetten am kalten Markt	3857				1987		11	1976	576	1400
08437114	Veringenstadt, Stadt	1703				894		4	890	275	615
08437118	Wald	2010				1086		4	1082	368	714
08437123	Sauldorf	1932				1029		1	1028	265	763
08437124	Herdwangen-Schönach	2508				1264		5	1259	611	648